name: Beach
groundImage: /images/elementsMap/fondSable.png
wallIndestructibleImage: /images/elementsMap/water.png
wallDestructibleImage: /images/elementsMap/sandCastle.png
layout:
111111111111111
100012222210001
101010120101011
100012222210001
121210121212121
122222022222221
111010101010111
122222022222221
121210121212121
100012222210001
101010120101011
100012222210001
111111111111111
