name: Classic
groundImage: /images/elementsMap/herbe.png
wallIndestructibleImage: /images/elementsMap/murIndestructible.png
wallDestructibleImage: /images/elementsMap/murDestructible.png
layout:
111111111111111
100022100012001
101010120101011
100022100012001
121212121212121
122222022222221
111010101010111
122222022222221
121212121212121
100022100012001
101010120101011
100022100012001
111111111111111
