name: Forest
groundImage: /images/elementsMap/fondFeuilles.png
wallIndestructibleImage: /images/elementsMap/soucheArbre.png
wallDestructibleImage: /images/elementsMap/buisson.png
layout:
111111111111111
100222222222001
100010111110001
120022222220021
121201112110121
121202222220121
121212101212121
121212002120121
121212101212121
121202222220121
100200111100201
100222222222001
111111111111111