name: Snow
groundImage: /images/elementsMap/fondNeige.png
wallIndestructibleImage: /images/elementsMap/blocGlasse.png
wallDestructibleImage: /images/elementsMap/BonhommeNeige.png
layout:
111111111111111
100022222220001
101011111110101
100022222220001
121212121212121
121212121212121
121212121212121
121212121212121
100022222220001
101011111110101
100022222220001
101011111110101
111111111111111