name: Volcan
groundImage: /images/elementsMap/solVolcanique.png
wallIndestructibleImage: /images/elementsMap/lave.png
wallDestructibleImage: /images/elementsMap/murDestructible.png
layout:
111111111111111
100022200220001
101010120101011
122220222022221
121212121212121
100022200220001
122211101112221
100022200220001
121212121212121
122220222022221
101010120101011
100022200220001
111111111111111
